Rk,Player,Pos,Age,Tm,G,GS,MP,FG,FGA,FG%,3P,3PA,3P%,2P,2PA,2P%,eFG%,FT,FTA,FT%,ORB,DRB,TRB,AST,STL,BLK,TOV,PF,PTS
1,Steven Adams\adamsst01,C,26,OKC,38,38,1052,187,303,.617,0,1,.000,187,302,.619,.617,73,128,.570,135,244,379,102,27,44,56,68,447
2,Bam Adebayo\adebaba01,C,22,MIA,40,40,1375,242,413,.586,1,9,.111,241,404,.597,.587,147,216,.681,104,313,417,184,50,48,110,103,632
3,LaMarcus Aldridge\aldrila01,C,34,SAS,37,37,1223,274,542,.506,44,100,.440,230,442,.520,.546,102,122,.836,73,207,280,91,20,65,50,87,694
4,Nickeil Alexander-Walker\alexani01,SG,21,NOP,33,0,453,72,208,.346,38,109,.349,34,99,.343,.438,15,24,.625,7,64,71,65,10,5,32,40,197
5,Grayson Allen\allengr01,SG,24,MEM,26,0,445,69,157,.439,32,84,.381,37,73,.507,.541,28,32,.875,5,55,60,37,6,1,22,34,198
6,Jarrett Allen\allenja01,C,21,BRK,40,36,1064,180,274,.657,0,3,.000,180,271,.664,.657,102,161,.634,126,262,388,49,28,51,46,99,462
7,Kadeem Allen\allenka01,SG,27,NYK,9,0,96,17,42,.405,5,16,.313,12,26,.462,.464,5,8,.625,2,6,8,19,4,2,8,7,44
8,Al-Farouq Aminu\aminual01,PF,29,ORL,18,2,380,25,86,.291,9,36,.250,16,50,.320,.343,19,29,.655,24,63,87,21,18,8,17,27,78
9,Justin Anderson\anderju01,SF,26,BRK,3,0,17,1,6,.167,0,3,.000,1,3,.333,.167,1,2,.500,0,2,2,0,0,1,0,2,3
10,Kyle Anderson\anderky01,PF,26,MEM,35,3,598,68,151,.450,7,33,.212,61,118,.517,.474,26,41,.634,34,101,135,76,25,15,27,50,169
11,Ryan Anderson\anderry01,PF,31,HOU,2,0,14,2,7,.286,1,5,.200,1,2,.500,.357,0,0,,0,7,7,2,1,0,1,1,5
12,Giannis Antetokounmpo\antetgi01,PF,25,MIL,40,40,1230,440,797,.552,66,204,.324,374,593,.631,.593,256,416,.615,94,420,514,221,46,43,135,125,1202
13,Kostas Antetokounmpo\antetko01,PF,22,LAL,3,0,5,0,0,,0,0,,0,0,,,0,0,,0,1,1,1,0,0,0,0,0
14,Thanasis Antetokounmpo\antetth01,SF,27,MIL,13,0,55,11,20,.550,0,2,.000,11,18,.611,.550,4,8,.500,6,1,7,6,1,1,5,7,26
15,Carmelo Anthony\anthoca01,PF,35,POR,27,27,860,167,379,.441,42,106,.396,125,273,.458,.496,65,78,.833,30,140,170,38,27,15,47,82,441
16,OG Anunoby\anunoog01,SF,22,TOR,39,38,1177,175,350,.500,56,147,.381,119,203,.586,.580,33,51,.647,40,186,226,66,43,27,48,98,439
17,Ryan Arcidiacono\arcidry01,PG,25,CHI,38,0,572,49,127,.386,31,77,.403,18,50,.360,.508,18,24,.750,14,51,65,58,16,2,21,63,147
18,Trevor Ariza\arizatr01,SF,34,SAC,32,0,791,64,165,.388,43,122,.352,21,43,.488,.518,21,27,.778,21,125,146,50,35,7,28,63,192
19,D.J. Augustin\augusdj01,PG,32,ORL,39,6,1013,128,326,.393,47,136,.346,81,190,.426,.465,114,130,.877,15,80,95,184,27,1,54,44,417
20,Deandre Ayton\aytonde01,C,21,PHO,11,6,340,86,154,.558,0,1,.000,86,153,.562,.558,13,17,.765,41,91,132,20,5,18,19,33,185
21,Dwayne Bacon\bacondw01,SG,24,CHO,34,10,621,84,231,.364,19,65,.292,65,166,.392,.405,33,51,.647,13,72,85,45,21,2,31,48,220
22,Marvin Bagley\baglema01,PF,20,SAC,11,4,265,63,135,.467,3,17,.176,60,118,.508,.478,24,30,.800,21,54,75,7,4,10,16,35,153
23,Lonzo Ball\balllo01,PG,22,NOP,34,25,1037,155,395,.392,76,216,.352,79,179,.441,.489,22,43,.512,40,149,189,209,41,12,92,65,408
24,Mo Bamba\bambamo01,C,21,ORL,38,0,585,83,189,.439,22,72,.306,61,117,.521,.497,15,24,.625,57,146,203,24,15,49,33,73,203
25,J.J. Barea\bareajo01,PG,35,DAL,12,3,187,43,94,.457,19,40,.475,24,54,.444,.559,5,5,1.000,5,17,22,39,3,1,15,6,110
26,Harrison Barnes\barneha02,PF,27,SAC,41,41,1441,216,478,.452,56,158,.354,160,320,.500,.510,143,180,.794,38,162,200,91,27,6,52,49,631
27,RJ Barrett\barrerj01,SG,19,NYK,41,41,1281,210,534,.393,47,143,.329,163,391,.417,.437,111,184,.603,44,171,215,101,43,16,90,92,578
28,Will Barton\bartowi01,SF,29,DEN,38,38,1269,219,486,.451,65,175,.371,154,311,.495,.517,69,91,.758,59,200,259,140,42,20,53,80,572
29,Keita Bates-Diop\bateske01,SF,24,MIN,28,0,509,69,163,.423,28,76,.368,41,87,.471,.509,40,56,.714,17,70,87,17,13,14,10,29,206
30,Nicolas Batum\batumni01,SF,31,CHO,20,2,454,26,71,.366,13,45,.289,13,26,.500,.458,6,6,1.000,20,68,88,59,16,8,21,37,71
31,Aron Baynes\baynear01,C,33,PHO,32,25,744,145,292,.497,41,122,.336,104,170,.612,.567,44,61,.721,54,134,188,61,7,19,38,116,375
32,Kent Bazemore\bazemke01,SF,30,POR,42,20,1080,109,318,.343,54,166,.325,55,152,.362,.428,57,70,.814,12,157,169,57,44,31,59,117,329
33,Darius Bazley\bazleda01,PF,19,OKC,41,6,691,62,173,.358,27,86,.314,35,87,.402,.436,18,28,.643,15,134,149,19,15,27,36,39,169
34,Bradley Beal\bealbr01,SG,26,WAS,33,33,1184,312,711,.439,81,262,.309,231,449,.514,.496,205,246,.833,36,118,154,213,34,10,108,77,910
35,Malik Beasley\beaslma01,SG,23,DEN,31,0,518,84,206,.408,44,111,.396,40,95,.421,.515,15,17,.882,6,46,52,30,17,5,25,36,227
36,Marco Belinelli\belinma01,SG,33,SAS,35,0,519,64,181,.354,32,95,.337,32,86,.372,.442,22,30,.733,2,54,56,43,8,0,13,25,182
37,Jordan Bell\belljo01,C,25,MIN,24,0,219,29,56,.518,2,8,.250,27,48,.563,.536,17,29,.586,27,46,73,14,2,9,18,14,77
38,DeAndre' Bembry\bembrde01,SG,25,ATL,40,4,859,102,220,.464,15,61,.246,87,159,.547,.498,22,43,.512,32,114,146,79,49,18,55,78,241
39,Dragan Bender\bendedr01,SF,22,MIL,4,0,50,6,11,.545,2,5,.400,4,6,.667,.636,1,1,1.000,0,9,9,5,0,3,1,10,15
40,Dāvis Bertāns\bertada01,PF,27,WAS,31,4,912,156,354,.441,116,267,.434,40,87,.460,.605,47,53,.887,25,129,154,52,20,19,25,78,475
41,Patrick Beverley\beverpa01,PG,31,LAC,34,34,975,104,247,.421,50,146,.342,54,101,.535,.522,22,36,.611,45,161,206,133,44,22,44,109,280
42,Khem Birch\birchkh01,C,27,ORL,28,17,603,40,82,.488,0,1,.000,40,81,.494,.488,28,50,.560,50,87,137,30,14,18,20,59,108
43,Goga Bitadze\bitadgo01,C,20,IND,32,2,301,38,81,.469,4,21,.190,34,60,.567,.494,18,25,.720,20,55,75,17,2,25,17,43,98
44,Bismack Biyombo\biyombi01,C,27,CHO,41,25,803,123,227,.542,0,0,,123,227,.542,.542,71,116,.612,97,149,246,36,9,34,35,91,317
45,Nemanja Bjelica\bjeline01,PF,31,SAC,41,38,1127,191,398,.480,82,189,.434,109,209,.522,.583,36,43,.837,63,206,269,104,37,24,63,124,500
46,Eric Bledsoe\bledser01,PG,30,MIL,35,35,908,196,411,.477,46,128,.359,150,283,.530,.533,96,115,.835,26,134,160,180,32,19,78,75,534
47,Bogdan Bogdanović\bogdabo01,SG,27,SAC,30,0,842,158,371,.426,79,206,.383,79,165,.479,.532,39,59,.661,10,79,89,108,32,8,61,61,434
48,Bojan Bogdanović\bogdabo02,SF,30,UTA,40,40,1335,278,619,.449,119,290,.410,159,329,.483,.545,167,185,.903,25,143,168,83,24,5,110,72,842
49,Jonah Bolden\boldejo01,PF,24,PHI,2,0,5,1,1,1.000,0,0,,1,1,1.000,1.000,0,2,.000,0,0,0,0,1,0,1,0,2
50,Jordan Bone\bonejo01,PG,22,DET,4,0,14,2,7,.286,0,2,.000,2,5,.400,.286,0,0,,0,0,0,3,0,0,2,2,4
51,Isaac Bonga\bongais01,SF,20,WAS,35,23,591,54,103,.524,7,24,.292,47,79,.595,.558,30,41,.732,32,78,110,40,23,11,20,76,145
52,Devin Booker\bookede01,SG,23,PHO,38,38,1362,345,683,.505,71,199,.357,274,484,.566,.557,235,257,.914,23,125,148,241,30,9,146,117,996
53,Chris Boucher\bouchch01,PF,27,TOR,36,0,475,76,168,.452,20,61,.328,56,107,.523,.512,52,71,.732,71,92,163,16,13,34,15,62,224
54,Brian Bowen\bowenbr02,SG,21,IND,3,0,10,1,4,.250,0,1,.000,1,3,.333,.250,0,0,,0,1,1,0,0,1,0,0,2
55,Ky Bowman\bowmaky01,PG,22,GSW,36,10,810,108,262,.412,31,89,.348,77,173,.445,.471,24,29,.828,18,74,92,104,35,5,45,82,271
56,Avery Bradley\bradlav01,SG,29,LAL,27,22,637,91,200,.455,21,71,.296,70,129,.543,.508,9,12,.750,13,50,63,30,24,2,30,64,212
57,Tony Bradley\bradlto01,C,22,UTA,30,2,300,56,90,.622,0,0,,56,90,.622,.622,18,28,.643,47,72,119,9,8,14,17,60,130
58,Jarrell Brantley\brantja01,PF,23,UTA,2,0,9,0,0,,0,0,,0,0,,,0,0,,0,4,4,1,0,2,1,1,0
59,Ignas Brazdeikis\brazdig01,SF,21,NYK,9,0,53,6,22,.273,1,9,.111,5,13,.385,.295,4,5,.800,2,3,5,4,0,1,2,3,17
60,Mikal Bridges\bridgmi01,SF,23,PHO,41,4,944,107,208,.514,20,68,.294,87,140,.621,.563,56,70,.800,33,125,158,56,56,17,38,82,290
61,Miles Bridges\bridgmi02,SF,21,CHO,44,44,1336,209,472,.443,64,185,.346,145,287,.505,.511,58,73,.795,56,187,243,81,27,33,74,98,540
62,Oshae Brissett\brissos01,SF,21,TOR,13,0,113,11,30,.367,3,12,.250,8,18,.444,.417,5,6,.833,8,12,20,4,3,1,4,15,30
63,Ryan Broekhoff\broekry01,SG,29,DAL,10,0,77,11,25,.440,10,20,.500,1,5,.200,.640,5,6,.833,1,13,14,4,2,1,2,7,37
64,Malcolm Brogdon\brogdma01,PG,27,IND,29,29,889,185,416,.445,41,121,.339,144,295,.488,.494,108,117,.923,21,110,131,215,24,5,75,57,519
65,Dillon Brooks\brookdi01,SG,24,MEM,41,41,1146,223,543,.411,87,226,.385,136,317,.429,.491,87,104,.837,39,97,136,85,40,16,64,157,620
66,Bruce Brown\brownbr01,SG,23,DET,41,32,1121,137,314,.436,22,67,.328,115,247,.466,.471,62,91,.681,40,140,180,160,51,22,69,109,358
67,Charlie Brown\brownch02,SG,22,ATL,5,0,27,3,10,.300,2,4,.500,1,6,.167,.400,5,5,1.000,2,2,4,1,0,2,0,0,13
68,Jaylen Brown\brownja02,SF,23,BOS,35,35,1169,254,516,.492,73,185,.395,181,331,.547,.563,118,156,.756,39,201,240,79,40,9,80,101,699
69,Moses Brown\brownmo01,C,20,POR,6,0,21,4,9,.444,0,0,,4,9,.444,.444,2,4,.500,2,8,10,0,1,0,2,4,10
70,Sterling Brown\brownst02,SF,24,MIL,30,0,470,56,146,.384,26,76,.342,30,70,.429,.473,23,30,.767,20,100,120,30,19,4,28,35,161
71,Troy Brown\browntr01,SG,20,WAS,37,14,955,146,323,.452,26,83,.313,120,240,.500,.492,58,75,.773,44,178,222,78,50,4,43,70,376
72,Jalen Brunson\brunsja01,PG,23,DAL,41,8,688,116,255,.455,27,87,.310,89,168,.530,.508,35,45,.778,18,79,97,135,16,3,41,54,294
73,Thomas Bryant\bryanth01,C,22,WAS,20,19,539,107,194,.552,11,36,.306,96,158,.608,.580,39,53,.736,45,114,159,50,8,18,25,46,264
74,Reggie Bullock\bullore01,SG,28,NYK,8,5,189,31,78,.397,13,40,.325,18,38,.474,.481,4,5,.800,5,7,12,12,13,0,1,16,79
75,Trey Burke\burketr01,PG,27,PHI,22,0,311,58,121,.479,16,36,.444,42,85,.494,.545,13,18,.722,14,20,34,50,7,1,12,19,145
76,Alec Burks\burksal01,SG,28,GSW,40,16,1165,203,497,.408,66,180,.367,137,317,.432,.475,164,183,.896,32,155,187,124,44,12,65,91,636
77,Deonte Burton\burtode02,SG,26,OKC,23,0,185,21,64,.328,5,31,.161,16,33,.485,.367,4,7,.571,5,26,31,9,3,4,6,20,51
78,Jimmy Butler\butleji01,SF,30,MIA,35,35,1229,210,472,.445,25,93,.269,185,379,.488,.471,272,332,.819,69,174,243,224,66,20,87,46,717
79,Bruno Caboclo\cabocbr01,SF,24,MEM,22,0,192,28,69,.406,4,25,.160,24,44,.545,.435,2,3,.667,17,27,44,10,10,12,7,23,62
80,Kentavious Caldwell-Pope\caldwke01,SG,26,LAL,41,20,1041,139,299,.465,59,138,.428,80,161,.497,.564,52,64,.813,25,66,91,74,32,8,36,77,389
81,Vlatko Čančar\cancavl01,SF,22,DEN,7,0,12,1,3,.333,0,1,.000,1,2,.500,.333,2,2,1.000,1,0,1,2,0,0,0,1,4
82,Clint Capela\capelca01,C,25,HOU,33,33,1108,214,336,.637,0,0,,214,336,.637,.637,52,92,.565,139,340,479,40,32,57,54,89,480
83,DeMarre Carroll\carrode01,SF,33,SAS,15,0,135,9,29,.310,3,13,.231,6,16,.375,.362,12,20,.600,7,24,31,11,2,2,10,20,33
84,Jevon Carter\carteje01,PG,24,PHO,26,2,340,33,88,.375,17,47,.362,16,41,.390,.472,6,8,.750,11,37,48,39,20,7,21,35,89
85,Vince Carter\cartevi01,SF,43,ATL,34,0,518,57,175,.326,32,117,.274,25,58,.431,.417,12,17,.706,6,57,63,32,12,14,19,55,158
86,Wendell Carter\cartewe01,C,20,CHI,37,37,1109,166,309,.537,6,28,.214,160,281,.569,.547,95,129,.736,130,236,366,44,30,33,62,142,433
87,Michael Carter-Williams\cartemi01,SG,28,ORL,19,0,310,35,93,.376,7,30,.233,28,63,.444,.414,22,31,.710,18,42,60,38,20,8,17,27,99
88,Alex Caruso\carusal01,PG,25,LAL,38,0,729,76,173,.439,26,71,.366,50,102,.490,.514,39,50,.780,10,63,73,68,38,10,35,60,217
89,Willie Cauley-Stein\caulewi01,C,26,GSW,38,34,869,133,237,.561,0,0,,133,237,.561,.561,33,55,.600,63,175,238,53,43,47,35,97,299
90,Tyson Chandler\chandty01,C,37,HOU,24,5,209,14,18,.778,0,0,,14,18,.778,.778,6,13,.462,24,39,63,6,6,8,7,29,34
91,Wilson Chandler\chandwi01,SF,32,BRK,13,0,260,31,72,.431,10,39,.256,21,33,.636,.500,9,10,.900,3,57,60,16,7,5,14,26,81
92,Zylan Cheatham\cheatzy01,SF,24,NOP,3,0,31,2,5,.400,0,1,.000,2,4,.500,.400,0,0,,1,5,6,2,0,1,3,5,4
93,Chris Chiozza\chiozch01,PG,24,WAS,10,0,123,10,34,.294,7,16,.438,3,18,.167,.397,0,0,,0,15,15,28,10,2,9,12,27
94,Marquese Chriss\chrisma01,PF,22,GSW,38,3,666,99,204,.485,5,22,.227,94,182,.516,.498,73,96,.760,70,133,203,71,23,34,54,75,276
95,Gary Clark\clarkga01,PF,25,TOT,20,0,249,27,69,.391,20,58,.345,7,11,.636,.536,6,7,.857,15,33,48,12,2,8,2,21,80
95,Gary Clark\clarkga01,PF,25,HOU,18,0,212,23,59,.390,18,51,.353,5,8,.625,.542,6,7,.857,11,29,40,12,2,7,2,21,70
95,Gary Clark\clarkga01,PF,25,ORL,2,0,37,4,10,.400,2,7,.286,2,3,.667,.500,0,0,,4,4,8,0,0,1,0,0,10
96,Brandon Clarke\clarkbr01,PF,23,MEM,35,2,744,180,287,.627,16,40,.400,164,247,.664,.655,53,66,.803,48,157,205,51,15,30,35,55,429
97,Jordan Clarkson\clarkjo01,SG,27,TOT,40,0,943,208,465,.447,82,223,.368,126,242,.521,.535,90,106,.849,27,63,90,83,25,12,49,52,588
97,Jordan Clarkson\clarkjo01,SG,27,CLE,29,0,666,144,326,.442,59,159,.371,85,167,.509,.532,76,86,.884,21,48,69,70,17,8,39,33,423
97,Jordan Clarkson\clarkjo01,SG,27,UTA,11,0,277,64,139,.460,23,64,.359,41,75,.547,.543,14,20,.700,6,15,21,13,8,4,10,19,165
98,Nicolas Claxton\claxtni01,PF,20,BRK,10,0,120,11,22,.500,0,5,.000,11,17,.647,.500,5,12,.417,8,14,22,11,1,5,6,10,27
99,Chris Clemons\clemoch01,SG,22,HOU,24,0,220,47,109,.431,33,85,.388,14,24,.583,.583,4,5,.800,2,18,20,18,6,5,14,20,131
100,Antonius Cleveland\clevean01,SG,25,DAL,3,0,14,2,3,.667,0,1,.000,2,2,1.000,.667,0,0,,0,3,3,0,0,0,1,0,4
101,Amir Coffey\coffeam01,SG,22,LAC,2,0,5,2,3,.667,1,2,.500,1,1,1.000,.833,0,0,,0,0,0,1,0,0,0,1,5
102,John Collins\collijo01,PF,22,ATL,15,15,457,104,208,.500,21,62,.339,83,146,.568,.550,31,41,.756,32,114,146,23,11,33,24,49,260
103,Zach Collins\colliza01,PF,22,POR,3,3,86,9,19,.474,3,7,.429,6,12,.500,.553,6,6,1.000,4,8,12,6,0,2,6,11,27
104,Mike Conley\conlemi01,PG,32,UTA,22,22,647,99,271,.365,40,111,.360,59,160,.369,.439,61,76,.803,16,57,73,102,16,4,45,48,299
105,Pat Connaughton\connapa01,SG,27,MIL,40,0,719,77,175,.440,26,91,.286,51,84,.607,.514,18,25,.720,31,138,169,69,12,22,33,40,198
106,Quinn Cook\cookqu01,PG,26,LAL,27,0,357,64,140,.457,20,54,.370,44,86,.512,.529,5,6,.833,5,29,34,37,9,1,22,20,153
107,Tyler Cook\cookty01,PF,22,CLE,8,0,28,6,8,.750,0,0,,6,8,.750,.750,5,6,.833,3,4,7,1,1,0,1,4,17
108,Robert Covington\covinro01,PF,29,MIN,39,38,1121,172,390,.441,86,242,.355,86,148,.581,.551,65,82,.793,28,196,224,46,68,38,59,114,495
109,Allen Crabbe\crabbal01,SG,27,ATL,28,1,522,52,143,.364,30,93,.323,22,50,.440,.469,9,12,.750,10,55,65,28,15,4,12,36,143
110,Torrey Craig\craigto01,SF,29,DEN,28,6,383,34,86,.395,10,42,.238,24,44,.545,.453,9,15,.600,18,44,62,18,9,14,11,53,87
111,Jae Crowder\crowdja01,SF,29,MEM,38,38,1147,132,351,.376,72,235,.306,60,116,.517,.479,60,77,.779,34,199,233,111,39,14,49,77,396
112,Jarrett Culver\culveja01,SG,20,MIN,39,26,947,150,380,.395,37,141,.262,113,239,.473,.443,32,73,.438,51,93,144,79,40,25,54,80,369
113,Seth Curry\curryse01,SG,29,DAL,39,9,876,143,312,.458,70,177,.395,73,135,.541,.571,50,55,.909,19,56,75,67,22,7,39,66,406
114,Stephen Curry\curryst01,PG,31,GSW,4,4,112,27,66,.409,9,37,.243,18,29,.621,.477,18,18,1.000,4,16,20,26,5,2,15,10,81
115,Troy Daniels\danietr01,SG,28,LAL,31,0,372,53,127,.417,34,89,.382,19,38,.500,.551,7,10,.700,7,30,37,11,7,2,7,21,147
116,Anthony Davis\davisan02,PF,26,LAL,35,35,1231,330,655,.504,38,128,.297,292,527,.554,.533,250,291,.859,78,251,329,113,54,90,84,89,948
117,Ed Davis\davised01,C,30,UTA,21,0,232,11,30,.367,0,0,,11,30,.367,.367,5,11,.455,23,61,84,8,9,9,13,49,27
118,Terence Davis\daviste02,SG,22,TOR,40,1,678,103,224,.460,49,127,.386,54,97,.557,.569,30,32,.938,28,106,134,75,23,7,39,59,285
119,Dewayne Dedmon\dedmode01,C,30,SAC,26,4,360,49,120,.408,12,56,.214,37,64,.578,.458,18,21,.857,29,75,104,9,9,12,36,64,128
120,Matthew Dellavedova\dellama01,PG,29,CLE,38,0,490,38,113,.336,10,61,.164,28,52,.538,.381,25,28,.893,12,36,48,103,15,1,31,57,111
121,DeMar DeRozan\derozde01,SF,30,SAS,39,39,1326,336,620,.542,8,25,.320,328,595,.551,.548,202,244,.828,23,185,208,197,39,12,96,110,882
122,Cheick Diallo\diallch01,C,23,PHO,25,0,231,47,71,.662,1,1,1.000,46,70,.657,.669,18,21,.857,15,48,63,13,6,4,13,23,113
123,Hamidou Diallo\diallha01,SF,21,OKC,21,1,400,60,139,.432,4,18,.222,56,121,.463,.446,23,35,.657,18,48,66,13,21,5,20,47,147
124,Gorgui Dieng\dienggo01,C,30,MIN,36,17,656,105,235,.447,36,96,.375,69,139,.496,.523,41,52,.788,62,154,216,50,33,35,34,75,287
125,Spencer Dinwiddie\dinwisp01,SG,26,BRK,40,29,1242,294,694,.424,75,255,.294,219,439,.499,.478,220,284,.775,16,111,127,258,29,14,115,126,883
126,Donte DiVincenzo\divindo01,SG,23,MIL,39,20,884,131,292,.449,48,142,.338,83,150,.553,.531,38,46,.826,34,140,174,89,60,10,45,64,348
127,Luka Dončić\doncilu01,PG,20,DAL,37,37,1213,346,742,.466,105,331,.317,241,411,.586,.537,268,341,.786,53,308,361,334,39,5,161,90,1065
128,Luguentz Dort\dortlu01,SG,20,OKC,7,0,115,8,25,.320,1,14,.071,7,11,.636,.340,6,10,.600,1,9,10,3,2,0,3,18,23
129,Damyean Dotson\dotsoda01,SG,25,NYK,36,0,595,80,204,.392,34,113,.301,46,91,.505,.475,16,24,.667,6,59,65,45,15,4,15,25,210
130,Sekou Doumbouya\doumbse01,SF,19,DET,15,8,267,47,90,.522,12,32,.375,35,58,.603,.589,15,23,.652,6,40,46,6,9,4,9,37,121
131,PJ Dozier\doziepj01,PG,23,DEN,2,0,20,5,10,.500,2,4,.500,3,6,.500,.600,0,0,,0,4,4,2,0,0,0,5,12
132,Goran Dragić\dragigo01,PG,33,MIA,30,1,836,161,358,.450,70,172,.407,91,186,.489,.547,76,106,.717,12,77,89,149,17,7,77,53,468
133,Andre Drummond\drumman01,C,26,DET,40,39,1344,284,535,.531,1,20,.050,283,515,.550,.532,123,204,.603,172,454,626,109,79,71,140,146,692
134,Jared Dudley\dudleja01,SF,34,LAL,28,1,247,16,38,.421,13,27,.481,3,11,.273,.592,2,2,1.000,3,25,28,17,9,2,5,32,47
135,Kris Dunn\dunnkr01,PG,25,CHI,42,23,1045,123,293,.420,24,97,.247,99,196,.505,.461,28,39,.718,21,128,149,140,84,14,51,138,298
136,Carsen Edwards\edwarca01,SG,21,BOS,27,0,267,29,95,.305,18,59,.305,11,36,.306,.400,11,13,.846,5,34,39,20,9,2,13,24,87
137,Henry Ellenson\ellenhe01,PF,23,BRK,5,0,15,1,7,.143,0,4,.000,1,3,.333,.143,0,0,,2,4,6,1,0,0,0,1,2
138,Wayne Ellington\ellinwa01,SG,32,NYK,23,1,330,32,99,.323,25,81,.309,7,18,.389,.449,4,6,.667,2,36,38,23,8,2,14,22,93
139,Joel Embiid\embiijo01,C,25,PHI,31,31,963,238,504,.472,38,118,.322,200,386,.518,.510,211,252,.837,79,303,382,102,25,42,93,109,725
140,James Ennis\ennisja01,SF,29,PHI,40,0,704,91,205,.444,35,96,.365,56,109,.514,.529,41,53,.774,46,92,138,36,19,13,26,81,258
141,Drew Eubanks\eubandr01,PF,22,SAS,7,0,38,9,14,.643,0,0,,9,14,.643,.643,3,3,1.000,6,10,16,2,0,1,4,5,21
142,Jacob Evans\evansja02,SG,22,GSW,21,0,311,32,104,.308,10,27,.370,22,77,.286,.356,19,23,.826,7,26,33,21,6,7,23,30,93
143,Dante Exum\exumda01,SG,24,TOT,19,0,223,33,65,.508,9,21,.429,24,44,.545,.577,14,19,.737,3,27,30,20,6,2,19,17,89
143,Dante Exum\exumda01,SG,24,UTA,11,0,83,10,23,.435,2,6,.333,8,17,.471,.478,2,2,1.000,3,9,12,7,1,2,10,8,24
143,Dante Exum\exumda01,SG,24,CLE,8,0,140,23,42,.548,7,15,.467,16,27,.593,.631,12,17,.706,0,18,18,13,5,0,9,9,65
144,Tacko Fall\fallta01,C,24,BOS,4,0,21,8,11,.727,0,0,,8,11,.727,.727,1,3,.333,0,10,10,0,0,2,3,4,17
145,Derrick Favors\favorde01,C,28,NOP,24,22,577,102,170,.600,1,4,.250,101,166,.608,.603,17,29,.586,82,160,242,49,14,28,32,54,222
146,Cristiano Felício\feliccr01,PF,27,CHI,2,0,9,0,1,.000,0,0,,0,1,.000,.000,0,0,,0,2,2,0,0,0,1,0,0
147,Terrance Ferguson\fergute01,SF,21,OKC,35,35,927,66,166,.398,41,128,.320,25,38,.658,.521,9,11,.818,20,40,60,34,21,12,26,116,182
148,Bruno Fernando\fernabr01,C,21,ATL,36,8,429,55,115,.478,4,27,.148,51,88,.580,.496,21,34,.618,38,72,110,36,9,12,29,63,135
149,Yogi Ferrell\ferreyo01,PG,26,SAC,30,0,386,53,126,.421,15,49,.306,38,77,.494,.480,28,32,.875,4,32,36,47,10,3,19,24,149
150,Dorian Finney-Smith\finnedo01,PF,26,DAL,41,38,1205,137,293,.468,64,168,.381,73,125,.584,.577,47,66,.712,80,136,216,56,27,21,39,92,385
151,Bryn Forbes\forbebr01,SG,26,SAS,39,38,1008,156,387,.403,89,243,.366,67,144,.465,.518,45,52,.865,10,82,92,71,20,0,36,71,446
152,Evan Fournier\fournev01,SG,27,ORL,41,41,1280,276,588,.469,102,258,.395,174,330,.527,.556,128,156,.821,6,101,107,132,43,7,77,101,782
153,De'Aaron Fox\foxde01,PG,22,SAC,23,21,717,158,330,.479,25,75,.333,133,255,.522,.517,101,143,.706,22,79,101,167,32,12,80,68,442
154,Melvin Frazier\frazime01,SG,23,ORL,11,0,43,6,17,.353,4,7,.571,2,10,.200,.471,2,4,.500,1,3,4,1,3,2,2,8,18
155,Michael Frazier\frazimi01,SG,25,HOU,2,0,14,2,5,.400,1,4,.250,1,1,1.000,.500,0,0,,1,2,3,1,0,0,0,2,5
156,Tim Frazier\fraziti01,PG,29,DET,24,11,318,33,87,.379,10,26,.385,23,61,.377,.437,19,24,.792,8,21,29,83,13,3,29,37,95
157,Markelle Fultz\fultzma01,PG,21,ORL,41,36,1111,198,435,.455,19,73,.260,179,362,.494,.477,65,88,.739,20,119,139,189,52,8,83,82,480
158,Wenyen Gabriel\gabriwe01,PF,22,SAC,11,0,61,6,17,.353,1,8,.125,5,9,.556,.382,6,10,.600,4,6,10,3,3,2,5,7,19
159,Daniel Gafford\gaffoda01,C,21,CHI,32,4,411,67,99,.677,0,0,,67,99,.677,.677,19,36,.528,38,39,77,14,9,42,15,60,153
160,Danilo Gallinari\gallida01,PF,31,OKC,35,35,1065,203,465,.437,103,257,.401,100,208,.481,.547,148,164,.902,20,174,194,79,23,4,46,48,657
161,Langston Galloway\gallola01,SG,28,DET,42,6,1056,143,334,.428,84,214,.393,59,120,.492,.554,57,66,.864,16,72,88,59,30,8,26,52,427
162,Darius Garland\garlada01,PG,20,CLE,41,41,1212,190,465,.409,76,210,.362,114,255,.447,.490,47,54,.870,17,63,80,146,32,0,104,62,503
163,Marc Gasol\gasolma01,C,35,TOR,28,28,794,69,182,.379,34,92,.370,35,90,.389,.473,21,28,.750,23,161,184,98,23,30,34,87,193
164,Rudy Gay\gayru01,PF,33,SAS,39,5,879,152,339,.448,43,130,.331,109,209,.522,.512,72,85,.847,39,189,228,71,19,23,57,56,419
165,Paul George\georgpa01,SF,29,LAC,26,26,799,198,462,.429,94,238,.395,104,224,.464,.530,120,132,.909,12,143,155,97,38,12,85,65,610
166,Taj Gibson\gibsota01,C,34,NYK,39,33,635,86,165,.521,2,10,.200,84,155,.542,.527,20,29,.690,69,98,167,39,22,14,34,88,194
167,Harry Giles\gilesha01,PF,21,SAC,16,3,180,35,77,.455,0,0,,35,77,.455,.455,11,12,.917,11,34,45,18,9,4,17,39,81
168,Shai Gilgeous-Alexander\gilgesh01,SG,21,OKC,41,41,1451,299,636,.470,51,145,.352,248,491,.505,.510,169,205,.824,29,205,234,122,50,19,80,65,818
169,Rudy Gobert\goberru01,C,27,UTA,39,39,1343,227,337,.674,0,0,,227,337,.674,.674,131,216,.606,142,422,564,66,28,75,76,122,585
170,Brandon Goodwin\goodwbr01,PG,24,ATL,12,1,163,30,72,.417,12,34,.353,18,38,.474,.500,8,8,1.000,3,20,23,19,8,3,12,19,80
171,Aaron Gordon\gordoaa01,PF,24,ORL,36,36,1122,186,437,.426,41,140,.293,145,297,.488,.473,78,112,.696,60,203,263,101,25,20,58,72,491
172,Eric Gordon\gordoer01,SG,31,HOU,16,4,462,74,210,.352,48,143,.336,26,67,.388,.467,23,37,.622,6,25,31,19,7,4,21,34,219
173,Devonte' Graham\grahade01,PG,24,CHO,44,34,1549,258,682,.378,160,413,.387,98,269,.364,.496,146,177,.825,36,126,162,339,39,13,132,82,822
174,Treveon Graham\grahatr01,SG,26,MIN,33,20,663,62,175,.354,20,83,.241,42,92,.457,.411,27,37,.730,29,71,100,30,17,2,19,66,171
175,Jerami Grant\grantje01,PF,25,DEN,41,8,981,143,313,.457,47,128,.367,96,185,.519,.532,76,111,.685,24,107,131,39,19,29,33,81,409
176,Josh Gray\grayjo01,PG,26,NOP,2,0,23,1,2,.500,0,0,,1,2,.500,.500,0,0,,1,1,2,2,0,0,5,1,2
177,Danny Green\greenda02,SG,32,LAL,40,40,1003,126,290,.434,76,199,.382,50,91,.549,.566,23,32,.719,28,117,145,55,47,18,33,89,351
178,Draymond Green\greendr01,PF,29,GSW,32,32,934,96,252,.381,26,97,.268,70,155,.452,.433,52,69,.754,18,185,203,180,48,25,73,83,270
179,JaMychal Green\greenja01,PF,29,LAC,33,0,700,77,191,.403,45,130,.346,32,61,.525,.521,25,29,.862,48,167,215,24,16,14,30,86,224
180,Javonte Green\greenja02,SF,26,BOS,32,0,248,38,68,.559,5,16,.313,33,52,.635,.596,12,15,.800,10,37,47,9,11,4,11,24,93
181,Jeff Green\greenje02,PF,33,UTA,30,2,553,75,195,.385,34,104,.327,41,91,.451,.472,49,63,.778,14,67,81,20,12,10,27,46,233
182,Blake Griffin\griffbl01,PF,30,DET,18,18,512,88,250,.352,27,111,.243,61,139,.439,.406,76,98,.776,17,67,84,59,7,7,40,27,279
183,Marko Guduric\gudurma01,SG,24,MEM,28,0,387,47,127,.370,18,64,.281,29,63,.460,.441,15,17,.882,12,42,54,38,9,6,28,25,127
184,Kyle Guy\guyky01,SG,22,SAC,1,0,3,0,1,.000,0,1,.000,0,0,,.000,0,0,,0,0,0,0,0,0,0,0,0
185,Rui Hachimura\hachiru01,PF,21,WAS,25,25,729,146,303,.482,10,48,.208,136,255,.533,.498,46,54,.852,39,106,145,40,18,3,20,57,348
186,Devon Hall\hallde01,SG,24,OKC,5,0,20,1,5,.200,0,2,.000,1,3,.333,.200,3,4,.750,0,1,1,3,0,0,1,1,5
187,Tim Hardaway\hardati02,SG,27,DAL,38,25,985,187,437,.428,99,258,.384,88,179,.492,.541,60,77,.779,15,96,111,66,23,4,31,63,533
188,James Harden\hardeja01,SG,30,HOU,39,39,1449,421,944,.446,195,523,.373,226,421,.537,.549,412,479,.860,43,199,242,291,66,35,182,126,1449
189,Maurice Harkless\harklma01,SF,26,LAC,42,30,956,95,185,.514,20,60,.333,75,125,.600,.568,22,40,.550,43,126,169,41,44,28,38,99,232
190,Jared Harper\harpeja01,PG,22,PHO,1,0,2,0,1,.000,0,1,.000,0,0,,.000,0,0,,0,0,0,0,0,0,0,0,0
191,Montrezl Harrell\harremo01,C,26,LAC,41,2,1181,320,558,.573,0,14,.000,320,544,.588,.573,147,231,.636,114,183,297,76,28,45,79,95,787
192,Gary Harris\harriga01,SG,25,DEN,37,37,1217,153,363,.421,50,158,.316,103,205,.502,.490,51,62,.823,20,82,102,81,54,10,38,87,407
193,Joe Harris\harrijo01,SF,28,BRK,40,40,1268,209,454,.460,99,240,.413,110,214,.514,.569,44,59,.746,37,131,168,85,27,12,56,95,561
194,Tobias Harris\harrito02,PF,27,PHI,42,42,1434,326,669,.487,71,198,.359,255,471,.541,.540,101,128,.789,33,251,284,125,33,25,66,99,824
195,Shaquille Harrison\harrish01,SF,26,CHI,25,4,183,23,60,.383,4,13,.308,19,47,.404,.417,15,23,.652,7,28,35,25,11,5,6,21,65
196,Josh Hart\hartjo01,SF,24,NOP,35,10,1001,127,311,.408,76,217,.350,51,94,.543,.531,46,62,.742,32,176,208,51,36,11,42,99,376
197,Isaiah Hartenstein\harteis01,C,21,HOU,18,2,238,40,59,.678,0,3,.000,40,56,.714,.678,18,26,.692,25,58,83,16,8,12,13,37,98
198,Udonis Haslem\hasleud01,PF,39,MIA,2,0,11,1,1,1.000,0,0,,1,1,1.000,1.000,3,4,.750,0,3,3,0,0,0,0,3,5
199,Jaxson Hayes\hayesja02,C,19,NOP,39,11,782,129,196,.658,1,4,.250,128,192,.667,.661,80,127,.630,70,114,184,36,21,46,32,114,339
200,Gordon Hayward\haywago01,SF,29,BOS,24,24,759,157,304,.516,34,97,.351,123,207,.594,.572,37,43,.860,23,119,142,95,17,10,37,42,385
201,John Henson\hensojo01,PF,29,CLE,20,1,264,41,76,.539,2,16,.125,39,60,.650,.553,10,21,.476,20,55,75,28,12,25,14,31,94
202,Dewan Hernandez\hernade01,C,23,TOR,4,0,11,1,5,.200,0,1,.000,1,4,.250,.200,2,2,1.000,2,5,7,0,1,0,1,6,4
203,Juan Hernangómez\hernaju01,PF,24,DEN,26,0,308,27,79,.342,13,47,.277,14,32,.438,.424,8,17,.471,13,49,62,18,2,3,12,19,75
204,Willy Hernangómez\hernawi01,C,25,CHO,15,0,109,26,46,.565,3,10,.300,23,36,.639,.598,11,23,.478,16,26,42,5,1,4,10,8,66
205,Tyler Herro\herroty01,SG,20,MIA,38,3,1078,186,446,.417,80,208,.385,106,238,.445,.507,57,67,.851,13,153,166,82,24,3,67,49,509
206,Kevin Hervey\herveke01,PF,23,OKC,3,0,9,0,4,.000,0,3,.000,0,1,.000,.000,0,0,,0,2,2,1,0,0,0,1,0
207,Mario Hezonja\hezonma01,PF,24,POR,30,4,484,47,120,.392,12,39,.308,35,81,.432,.442,30,36,.833,17,99,116,27,18,4,22,66,136
208,Buddy Hield\hieldbu01,SG,27,SAC,41,41,1407,304,728,.418,147,400,.368,157,328,.479,.519,77,94,.819,37,170,207,128,34,12,109,105,832
209,George Hill\hillge01,PG,33,MIL,40,0,851,142,260,.546,63,120,.525,79,140,.564,.667,51,63,.810,38,89,127,122,29,4,35,57,398
210,Solomon Hill\hillso01,SF,28,MEM,39,2,741,80,200,.400,45,122,.369,35,78,.449,.513,19,26,.731,22,105,127,77,29,6,31,57,224
211,Jaylen Hoard\hoardja01,SF,20,POR,10,0,64,9,22,.409,0,2,.000,9,20,.450,.409,6,9,.667,8,10,18,2,4,0,4,4,24
212,Aaron Holiday\holidaa01,PG,23,IND,39,18,926,150,359,.418,60,147,.408,90,212,.425,.501,45,52,.865,15,78,93,142,32,7,56,73,405
213,Jrue Holiday\holidjr01,SG,29,NOP,34,34,1212,266,608,.438,67,196,.342,199,412,.483,.493,68,96,.708,45,120,165,221,58,25,105,72,667
214,Justin Holiday\holidju01,SG,30,IND,41,2,1036,114,275,.415,73,179,.408,41,96,.427,.547,27,33,.818,17,123,140,61,41,22,23,71,328
215,Rondae Hollis-Jefferson\holliro01,SF,25,TOR,32,2,646,98,208,.471,2,13,.154,96,195,.492,.476,67,89,.753,74,92,166,49,27,12,33,68,265
216,Richaun Holmes\holmeri01,C,26,SAC,37,33,1087,204,309,.660,0,0,,204,309,.660,.660,76,93,.817,113,201,314,37,39,52,46,144,484
217,Rodney Hood\hoodro01,SF,27,POR,21,21,619,87,172,.506,35,71,.493,52,101,.515,.608,21,27,.778,10,62,72,32,17,4,19,46,230
218,Al Horford\horfoal01,C,33,PHI,38,38,1176,194,432,.449,53,159,.333,141,273,.516,.510,33,48,.688,64,186,250,148,38,37,41,86,474
219,Talen Horton-Tucker\hortota01,SG,19,LAL,2,0,5,0,1,.000,0,1,.000,0,0,,.000,0,0,,0,0,0,2,1,0,0,0,0
220,Danuel House\houseda01,SF,26,HOU,34,29,1037,120,279,.430,67,181,.370,53,98,.541,.550,40,54,.741,37,96,133,42,30,17,32,76,347
221,Dwight Howard\howardw01,C,34,LAL,41,0,813,128,177,.723,3,5,.600,125,172,.727,.732,56,111,.505,102,205,307,29,15,59,51,134,315
222,Kevin Huerter\huertke01,SG,21,ATL,30,22,830,124,293,.423,63,157,.401,61,136,.449,.531,38,45,.844,18,109,127,108,28,13,52,65,349
223,De'Andre Hunter\huntede01,SF,22,ATL,40,39,1242,175,434,.403,64,190,.337,111,244,.455,.477,65,84,.774,18,128,146,68,25,9,64,107,479
224,Chandler Hutchison\hutchch01,SF,23,CHI,15,6,220,29,66,.439,6,14,.429,23,52,.442,.485,23,37,.622,2,41,43,9,9,5,15,20,87
225,Serge Ibaka\ibakase01,C,30,TOR,30,13,799,184,366,.503,28,75,.373,156,291,.536,.541,58,79,.734,67,189,256,37,13,28,63,82,454
226,Ersan İlyasova\ilyaser01,PF,32,MIL,39,4,654,114,227,.502,37,100,.370,77,127,.606,.584,51,62,.823,48,162,210,38,16,13,22,60,316
227,Joe Ingles\inglejo01,SF,32,UTA,41,21,1231,160,353,.453,93,219,.425,67,134,.500,.585,46,58,.793,16,154,170,192,39,6,76,87,459
228,Brandon Ingram\ingrabr01,PF,22,NOP,37,37,1277,332,691,.480,93,229,.406,239,462,.517,.548,196,228,.860,34,217,251,158,35,30,113,107,953
229,Kyrie Irving\irvinky01,PG,27,BRK,14,14,461,140,303,.462,36,99,.364,104,204,.510,.521,65,71,.915,15,59,74,97,17,8,31,35,381
230,Jonathan Isaac\isaacjo01,SF,22,ORL,32,32,949,149,322,.463,30,91,.330,119,231,.515,.509,56,73,.767,57,165,222,44,50,78,47,79,384
231,Wesley Iwundu\iwundwe01,SF,25,ORL,28,9,505,45,125,.360,9,35,.257,36,90,.400,.396,41,48,.854,18,60,78,28,17,9,15,42,140
232,Frank Jackson\jacksfr01,PG,21,NOP,33,1,458,74,191,.387,24,86,.279,50,105,.476,.450,34,44,.773,10,34,44,28,11,2,30,46,206
233,Jaren Jackson\jacksja02,C,20,MEM,40,40,1128,261,541,.482,107,258,.415,154,283,.544,.581,90,119,.756,45,149,194,60,28,58,67,165,719
234,Justin Jackson\jacksju01,PF,24,DAL,37,2,590,87,210,.414,34,107,.318,53,103,.515,.495,23,28,.821,14,74,88,21,9,4,7,45,231
235,Reggie Jackson\jacksre01,PG,29,DET,2,2,36,4,11,.364,1,5,.200,3,6,.500,.409,1,1,1.000,1,4,5,8,0,0,1,2,10
236,Justin James\jamesju01,SG,23,SAC,22,0,192,27,67,.403,7,23,.304,20,44,.455,.455,3,11,.273,4,23,27,13,5,9,7,14,64
237,LeBron James\jamesle01,PG,35,LAL,39,39,1362,378,770,.491,83,240,.346,295,530,.557,.545,150,216,.694,40,261,301,424,50,20,146,69,989
238,Amile Jefferson\jeffeam01,PF,26,ORL,14,0,68,4,11,.364,0,0,,4,11,.364,.364,4,12,.333,8,13,21,4,0,3,3,6,12
239,DaQuan Jeffries\jeffrda01,SG,22,SAC,2,0,11,1,1,1.000,0,0,,1,1,1.000,1.000,0,0,,1,0,1,1,0,0,0,1,2
240,Ty Jerome\jeromty01,PG,22,PHO,12,0,137,16,49,.327,6,20,.300,10,29,.345,.388,4,5,.800,3,14,17,23,11,0,9,14,42
241,Alize Johnson\johnsal02,SF,23,IND,11,0,46,7,14,.500,0,0,,7,14,.500,.500,4,6,.667,6,9,15,2,0,0,1,6,18
242,B.J. Johnson\johnsbj01,SF,24,ORL,4,0,38,5,14,.357,1,5,.200,4,9,.444,.393,0,0,,1,3,4,2,2,0,3,0,11
243,Cameron Johnson\johnsca02,PF,23,PHO,38,0,754,102,243,.420,66,166,.398,36,77,.468,.556,27,36,.750,35,81,116,36,17,12,24,56,297
244,James Johnson\johnsja01,PF,32,MIA,10,0,137,22,40,.550,10,20,.500,12,20,.600,.675,8,13,.615,7,19,26,8,3,5,8,16,62
245,Keldon Johnson\johnske04,SF,20,SAS,2,0,7,1,4,.250,0,0,,1,4,.250,.250,0,0,,0,2,2,0,0,0,0,0,2
246,Stanley Johnson\johnsst04,PF,23,TOR,12,0,66,7,25,.280,2,12,.167,5,13,.385,.320,3,4,.750,3,12,15,2,3,1,7,6,19
247,Tyler Johnson\johnsty01,SG,27,PHO,28,3,473,59,157,.376,20,74,.270,39,83,.470,.439,22,30,.733,10,41,51,47,10,7,22,38,160
248,Nikola Jokić\jokicni01,C,24,DEN,41,41,1289,306,600,.510,54,163,.331,252,437,.577,.555,122,152,.803,94,311,405,264,38,24,110,125,788
249,Damian Jones\jonesda03,C,24,ATL,36,20,603,92,133,.692,2,6,.333,90,127,.709,.699,42,58,.724,52,82,134,24,13,30,20,107,228
250,Derrick Jones\jonesde02,SF,22,MIA,26,1,632,81,173,.468,16,69,.232,65,104,.625,.514,45,59,.763,21,89,110,24,30,19,18,63,223
251,Tyus Jones\jonesty01,PG,23,MEM,41,6,788,106,242,.438,21,65,.323,85,177,.480,.481,24,32,.750,5,58,63,190,38,5,41,30,257
252,DeAndre Jordan\jordade01,C,31,BRK,37,4,777,120,183,.656,0,0,,120,183,.656,.656,55,81,.679,87,273,360,73,15,35,48,73,295
253,Cory Joseph\josepco01,PG,28,SAC,41,20,1047,101,259,.390,26,83,.313,75,176,.426,.440,33,37,.892,23,87,110,148,31,14,48,83,261
254,Mfiondu Kabengele\kabenmf01,C,22,LAC,10,0,44,10,22,.455,6,12,.500,4,10,.400,.591,3,3,1.000,1,7,8,1,1,1,1,6,29
255,Frank Kaminsky\kaminfr01,C,26,PHO,32,13,718,127,279,.455,39,112,.348,88,167,.527,.525,59,88,.670,30,128,158,71,13,10,33,69,352
256,Enes Kanter\kanteen01,C,27,BOS,33,4,606,131,223,.587,1,5,.200,130,218,.596,.590,40,58,.690,97,173,270,34,16,29,34,58,303
257,Luke Kennard\kennalu01,SG,23,DET,28,25,922,151,342,.442,73,183,.399,78,159,.491,.548,67,75,.893,9,89,98,115,12,6,43,65,442
258,Stanton Kidd\kiddst01,SF,27,UTA,4,0,15,0,3,.000,0,1,.000,0,2,.000,.000,0,0,,0,3,3,1,0,0,2,3,0
259,Michael Kidd-Gilchrist\kiddgmi01,PF,26,CHO,12,0,160,18,53,.340,5,17,.294,13,36,.361,.387,7,9,.778,9,26,35,10,0,3,7,18,48
260,Louis King\kinglo02,SF,20,DET,4,0,12,3,7,.429,1,3,.333,2,4,.500,.500,0,0,,1,1,2,1,1,0,1,2,7
261,Maxi Kleber\klebima01,C,28,DAL,40,9,996,124,264,.470,67,165,.406,57,99,.576,.597,48,55,.873,61,156,217,41,13,34,32,89,363
262,Brandon Knight\knighbr03,PG,28,CLE,16,0,241,28,86,.326,19,64,.297,9,22,.409,.436,4,13,.308,3,17,20,31,5,2,16,20,79
263,Kevin Knox\knoxke01,SF,20,NYK,41,4,803,106,282,.376,49,146,.336,57,136,.419,.463,50,77,.649,16,115,131,45,20,17,28,66,311
264,John Konchar\konchjo01,SG,23,MEM,2,0,8,0,0,,0,0,,0,0,,,0,0,,0,1,1,0,0,0,0,0,0
265,Furkan Korkmaz\korkmfu01,SG,22,PHI,41,11,831,123,288,.427,65,173,.376,58,115,.504,.540,23,33,.697,10,80,90,33,23,7,27,53,334
266,Luke Kornet\kornelu01,C,24,CHI,22,0,246,28,77,.364,12,47,.255,16,30,.533,.442,6,7,.857,8,31,39,11,5,17,4,21,74
267,Kyle Korver\korveky01,SF,38,MIL,37,0,613,74,181,.409,60,144,.417,14,37,.378,.575,21,24,.875,9,59,68,44,17,7,31,44,229
268,Rodions Kurucs\kurucro01,PF,21,BRK,25,3,323,40,84,.476,15,33,.455,25,51,.490,.565,10,18,.556,14,51,65,22,10,2,24,46,105
269,Kyle Kuzma\kuzmaky01,PF,24,LAL,32,5,781,153,356,.430,53,155,.342,100,201,.498,.504,53,71,.746,23,99,122,34,10,13,48,56,412
270,Skal Labissière\labissk01,C,23,POR,33,1,567,81,147,.551,3,13,.231,78,134,.582,.561,25,33,.758,65,104,169,42,7,31,30,89,190
271,Jeremy Lamb\lambje01,SG,27,IND,30,30,878,146,328,.445,37,110,.336,109,218,.500,.502,66,77,.857,18,127,145,71,37,15,38,66,395
272,Romeo Langford\langfro01,SG,20,BOS,11,0,106,8,20,.400,2,9,.222,6,11,.545,.450,7,8,.875,5,6,11,2,3,2,2,7,25
273,Zach LaVine\lavinza01,SG,24,CHI,42,42,1425,354,805,.440,134,335,.400,220,470,.468,.523,193,233,.828,29,166,195,169,58,19,137,92,1035
274,Jake Layman\laymaja01,PF,25,MIN,14,2,369,61,132,.462,19,54,.352,42,78,.538,.534,6,10,.600,12,29,41,11,12,10,18,31,147
275,T.J. Leaf\leaftj01,PF,22,IND,21,1,177,27,65,.415,5,14,.357,22,51,.431,.454,6,10,.600,20,39,59,6,7,3,6,16,65
276,Jalen Lecque\lecquja01,G,19,PHO,1,0,2,0,1,.000,0,0,,0,1,.000,.000,0,0,,0,0,0,0,0,0,0,0,0
277,Courtney Lee\leeco01,SG,34,DAL,10,3,80,13,23,.565,7,12,.583,6,11,.545,.717,0,0,,0,5,5,3,0,2,2,6,33
278,Damion Lee\leeda03,SG,27,GSW,27,14,734,114,280,.407,39,109,.358,75,171,.439,.477,75,85,.882,25,117,142,67,24,2,36,50,342
279,Alex Len\lenal01,C,26,ATL,38,9,711,139,251,.554,14,54,.259,125,197,.635,.582,50,79,.633,64,155,219,42,18,30,37,89,342
280,Kawhi Leonard\leonaka01,SF,28,LAC,32,32,1025,299,643,.465,63,170,.371,236,473,.499,.514,187,210,.890,33,201,234,161,60,18,104,60,848
281,Meyers Leonard\leoname01,PF,27,MIA,40,40,808,94,175,.537,41,92,.446,53,83,.639,.654,12,18,.667,21,178,199,46,10,14,29,84,241
282,Caris LeVert\leverca01,SG,25,BRK,15,9,417,88,215,.409,23,62,.371,65,153,.425,.463,32,52,.615,15,46,61,51,10,2,45,27,231
283,Damian Lillard\lillada01,PG,29,POR,40,40,1466,335,755,.444,135,376,.359,200,379,.528,.533,266,299,.890,20,147,167,303,38,15,110,72,1071
284,Nassir Little\littlna01,PF,19,POR,31,3,384,38,97,.392,7,37,.189,31,60,.517,.428,21,33,.636,23,59,82,15,8,9,12,44,104
285,Kevon Looney\looneke01,C,23,GSW,10,3,105,11,32,.344,1,2,.500,10,30,.333,.359,3,5,.600,15,14,29,4,3,2,6,17,26
286,Brook Lopez\lopezbr01,C,31,MIL,41,41,1076,149,359,.415,58,191,.304,91,168,.542,.496,60,69,.870,26,168,194,61,30,102,37,92,416
287,Robin Lopez\lopezro01,C,31,MIL,42,2,600,98,192,.510,17,63,.270,81,129,.628,.555,20,39,.513,40,75,115,28,6,29,37,53,233
288,Kevin Love\loveke01,PF,31,CLE,34,34,1061,192,422,.455,79,213,.371,113,209,.541,.549,116,136,.853,30,322,352,98,19,13,94,52,579
289,Kyle Lowry\lowryky01,PG,33,TOR,29,29,1110,176,436,.404,91,258,.353,85,178,.478,.508,151,176,.858,16,115,131,227,34,13,87,92,594
290,Timothé Luwawu-Cabarrot\luwawti01,SG,24,BRK,18,0,307,29,75,.387,12,37,.324,17,38,.447,.467,14,19,.737,9,33,42,12,9,1,16,35,84
291,Trey Lyles\lylestr01,PF,24,SAS,39,29,673,71,174,.408,29,88,.330,42,86,.488,.491,15,22,.682,49,175,224,48,10,13,23,50,186
292,Daryl Macon\maconda01,SG,24,MIA,4,0,14,1,3,.333,1,2,.500,0,1,.000,.500,0,0,,0,0,0,1,0,0,2,1,3
293,Josh Magette\magetjo01,PG,30,ORL,8,0,38,5,15,.333,1,4,.250,4,11,.364,.367,1,2,.500,1,5,6,5,3,1,5,4,12
294,Ian Mahinmi\mahinia01,C,33,WAS,20,17,442,57,113,.504,4,16,.250,53,97,.546,.522,40,67,.597,47,69,116,30,17,29,29,61,158
295,Thon Maker\makerth01,C,22,DET,40,3,440,48,95,.505,10,30,.333,38,65,.585,.558,43,67,.642,26,54,80,16,13,22,26,58,149
296,Terance Mann\mannte01,SG,23,LAC,26,5,220,21,47,.447,2,10,.200,19,37,.514,.468,8,10,.800,4,23,27,29,6,3,13,27,52
297,Boban Marjanović\marjabo01,C,31,DAL,21,1,209,54,99,.545,2,7,.286,52,92,.565,.556,19,28,.679,31,64,95,8,3,3,16,33,129
298,Lauri Markkanen\markkla01,PF,22,CHI,42,42,1268,213,502,.424,93,264,.352,120,238,.504,.517,113,138,.819,52,225,277,67,34,21,68,86,632
299,Caleb Martin\martica02,SF,24,CHO,5,0,32,3,10,.300,0,3,.000,3,7,.429,.300,3,5,.600,1,4,5,3,1,2,3,3,9
300,Cody Martin\martico01,SF,24,CHO,31,0,444,41,103,.398,8,40,.200,33,63,.524,.437,29,42,.690,17,59,76,37,22,5,18,43,119
301,Kelan Martin\martike03,SF,24,MIN,17,3,295,39,109,.358,15,57,.263,24,52,.462,.427,5,5,1.000,5,53,58,9,3,5,6,32,98
302,Frank Mason\masonfr01,PG,25,MIL,4,0,18,1,7,.143,1,4,.250,0,3,.000,.214,2,4,.500,1,1,2,5,1,0,1,2,5
303,Garrison Mathews\mathega01,SG,23,WAS,15,0,196,23,50,.460,18,42,.429,5,8,.625,.640,29,32,.906,6,17,23,10,3,1,7,26,93
304,Wesley Matthews\matthwe02,SG,33,MIL,40,40,968,97,246,.394,59,167,.353,38,79,.481,.514,32,41,.780,9,90,99,55,26,6,25,59,285
305,Patrick McCaw\mccawpa01,SF,24,TOR,19,11,518,48,110,.436,16,47,.340,32,63,.508,.509,7,9,.778,10,38,48,49,23,1,21,34,119
306,CJ McCollum\mccolcj01,SG,28,POR,41,41,1483,357,787,.454,109,287,.380,248,500,.496,.523,75,95,.789,29,140,169,157,33,28,73,104,898
307,T.J. McConnell\mccontj01,PG,27,IND,39,1,734,120,234,.513,4,11,.364,116,223,.520,.521,19,25,.760,20,82,102,205,25,5,56,41,263
308,Jalen McDaniels\mcdanja01,PF,22,CHO,2,0,7,2,5,.400,0,1,.000,2,4,.500,.400,0,0,,1,0,1,0,0,0,0,0,4
309,Doug McDermott\mcderdo01,PF,28,IND,41,0,846,147,318,.462,72,166,.434,75,152,.493,.575,27,33,.818,19,89,108,45,6,4,26,72,393
310,JaVale McGee\mcgeeja01,C,32,LAL,41,41,696,128,200,.640,2,3,.667,126,197,.640,.645,30,49,.612,78,163,241,29,24,69,31,100,288
311,Rodney McGruder\mcgruro01,SG,28,LAC,30,2,496,41,104,.394,18,61,.295,23,43,.535,.481,7,14,.500,17,68,85,19,15,7,12,50,107
312,Alfonzo McKinnie\mckinal01,SF,27,CLE,27,1,333,34,91,.374,9,38,.237,25,53,.472,.423,9,14,.643,19,42,61,9,13,4,15,42,86
313,Jordan McLaughlin\mclaujo01,PG,23,MIN,6,0,94,11,32,.344,4,15,.267,7,17,.412,.406,4,4,1.000,1,9,10,16,5,0,5,6,30
314,Ben McLemore\mclembe01,SG,26,HOU,40,11,968,138,328,.421,102,278,.367,36,50,.720,.576,36,45,.800,15,84,99,38,27,10,33,81,414
315,Jordan McRae\mcraejo01,SG,28,WAS,24,4,553,118,272,.434,37,87,.425,81,185,.438,.502,57,73,.781,16,69,85,69,17,13,33,47,330
316,Nicolò Melli\mellini01,C,29,NOP,31,5,476,59,138,.428,28,85,.329,31,53,.585,.529,30,37,.811,16,58,74,31,20,5,21,54,176
317,De'Anthony Melton\meltode01,PG,21,MEM,30,0,520,84,184,.457,18,57,.316,66,127,.520,.505,53,61,.869,23,94,117,91,37,11,42,56,239
318,Chimezie Metu\metuch01,PF,22,SAS,11,0,41,13,22,.591,0,0,,13,22,.591,.591,4,6,.667,8,9,17,3,1,3,1,1,30
319,Khris Middleton\middlkh01,SF,28,MIL,36,33,1022,256,521,.491,77,188,.410,179,333,.538,.565,108,121,.893,30,176,206,137,35,6,71,81,697
320,C.J. Miles\milescj01,SG,32,WAS,10,0,161,19,59,.322,11,35,.314,8,24,.333,.415,15,20,.750,4,8,12,12,10,4,4,14,64
321,Malcolm Miller\millema01,SF,26,TOR,20,1,110,6,19,.316,5,15,.333,1,4,.250,.447,1,6,.167,1,13,14,8,4,2,3,10,18
322,Patty Mills\millspa02,PG,31,SAS,39,1,906,156,354,.441,90,221,.407,66,133,.496,.568,53,67,.791,11,50,61,79,32,5,36,59,455
323,Paul Millsap\millspa01,PF,34,DEN,32,32,798,132,282,.468,31,75,.413,101,207,.488,.523,85,96,.885,64,122,186,45,28,22,42,90,380
324,Shake Milton\miltosh01,SG,23,PHI,12,0,102,16,42,.381,5,22,.227,11,20,.550,.440,10,13,.769,2,13,15,9,1,1,13,15,47
325,Donovan Mitchell\mitchdo01,SG,23,UTA,40,40,1387,368,800,.460,92,253,.364,276,547,.505,.518,162,190,.853,31,141,172,174,45,10,97,97,990
326,Naz Mitrou-Long\mitrona01,SG,26,IND,3,0,43,6,16,.375,2,11,.182,4,5,.800,.438,0,0,,0,6,6,7,1,1,2,1,14
327,Adam Mokoka\mokokad01,SG,21,CHI,2,0,6,0,5,.000,0,2,.000,0,3,.000,.000,0,0,,2,0,2,0,0,0,0,0,0
328,Malik Monk\monkma01,SG,21,CHO,42,0,806,132,313,.422,37,144,.257,95,169,.562,.481,42,53,.792,18,92,110,82,18,9,52,57,343
329,E'Twaun Moore\mooreet01,SG,30,NOP,30,5,648,123,291,.423,45,113,.398,78,178,.438,.500,21,34,.618,23,72,95,53,20,5,23,53,312
330,Ja Morant\moranja01,PG,20,MEM,35,35,1040,237,480,.494,33,81,.407,204,399,.511,.528,123,153,.804,23,98,121,243,35,10,115,58,630
331,Juwan Morgan\morgaju01,PF,22,UTA,7,0,28,2,5,.400,0,3,.000,2,2,1.000,.400,0,0,,0,4,4,1,0,1,2,2,4
332,Marcus Morris\morrima03,SF,30,NYK,34,34,1081,210,481,.437,92,197,.467,118,284,.415,.532,134,163,.822,39,147,186,51,29,15,55,99,646
333,Markieff Morris\morrima02,PF,30,DET,34,15,752,135,297,.455,57,144,.396,78,153,.510,.551,42,56,.750,19,110,129,54,22,8,56,81,369
334,Monte Morris\morrimo01,PG,24,DEN,41,1,747,124,278,.446,28,68,.412,96,210,.457,.496,33,41,.805,11,52,63,137,26,9,24,31,309
335,Johnathan Motley\motlejo01,PF,24,LAC,7,0,17,3,5,.600,1,1,1.000,2,4,.500,.700,2,2,1.000,1,1,2,5,3,0,4,5,9
336,Emmanuel Mudiay\mudiaem01,PG,23,UTA,38,1,661,118,245,.482,22,64,.344,96,181,.530,.527,40,55,.727,13,86,99,95,16,8,57,56,298
337,Dejounte Murray\murrade01,PG,23,SAS,35,27,837,147,301,.488,15,45,.333,132,256,.516,.513,46,58,.793,41,163,204,144,57,10,74,78,355
338,Jamal Murray\murraja01,PG,22,DEN,40,40,1279,260,598,.435,64,199,.322,196,399,.491,.488,120,131,.916,33,130,163,183,54,11,85,68,704
339,Džanan Musa\musadz01,SF,20,BRK,28,0,359,43,120,.358,13,57,.228,30,63,.476,.413,29,37,.784,13,45,58,28,10,1,26,20,128
340,Mike Muscala\muscami01,C,28,OKC,27,0,321,37,108,.343,22,79,.278,15,29,.517,.444,15,18,.833,11,57,68,24,6,6,10,31,111
341,Sviatoslav Mykhailiuk\mykhasv01,SF,22,DET,37,12,760,95,227,.419,72,166,.434,23,61,.377,.577,25,31,.806,10,45,55,62,23,2,36,50,287
342,Abdel Nader\naderab01,SF,26,OKC,32,5,520,71,151,.470,28,77,.364,43,74,.581,.563,28,35,.800,10,41,51,24,11,10,28,42,198
343,Larry Nance\nancela02,C,27,CLE,32,5,772,97,198,.490,29,87,.333,68,111,.613,.563,26,39,.667,52,168,220,51,26,15,30,49,249
344,Shabazz Napier\napiesh01,PG,28,MIN,27,13,589,83,217,.382,33,121,.273,50,96,.521,.459,55,67,.821,6,61,67,116,27,6,54,39,254
345,Raul Neto\netora01,PG,27,PHI,33,2,348,52,106,.491,17,41,.415,35,65,.538,.571,10,12,.833,5,26,31,46,15,2,27,23,131
346,Georges Niang\niangge01,PF,26,UTA,35,0,462,67,146,.459,44,101,.436,23,45,.511,.610,9,12,.750,8,59,67,20,6,4,14,45,187
347,Nerlens Noel\noelne01,C,25,OKC,34,3,625,101,153,.660,0,0,,101,153,.660,.660,59,73,.808,57,116,173,42,36,52,35,85,261
348,Zach Norvell\norveza01,SG,22,LAL,2,0,5,0,1,.000,0,0,,0,1,.000,.000,0,0,,0,1,1,0,0,0,0,0,0
349,Jaylen Nowell\nowelja01,SG,20,MIN,7,0,81,11,31,.355,2,17,.118,9,14,.643,.387,7,8,.875,2,3,5,6,0,1,3,3,31
350,Frank Ntilikina\ntilila01,PG,21,NYK,38,24,839,85,219,.388,30,93,.323,55,126,.437,.457,33,38,.868,16,66,82,123,41,14,50,100,233
351,Kendrick Nunn\nunnke01,SG,24,MIA,40,40,1209,253,554,.457,80,231,.346,173,323,.536,.529,48,60,.800,11,97,108,143,37,8,70,95,634
352,David Nwaba\nwabada01,SF,27,BRK,20,0,268,37,71,.521,12,28,.429,25,43,.581,.606,18,27,.667,8,37,45,8,11,12,8,32,104
353,Royce O'Neale\onealro01,PF,26,UTA,41,38,1210,93,195,.477,54,120,.450,39,75,.520,.615,20,24,.833,9,195,204,102,33,14,33,124,260
354,Kyle O'Quinn\oquinky01,C,29,PHI,19,1,195,26,53,.491,6,18,.333,20,35,.571,.547,3,8,.375,22,49,71,28,2,15,17,25,61
355,Semi Ojeleye\ojelese01,PF,25,BOS,38,4,544,34,88,.386,21,56,.375,13,32,.406,.506,11,14,.786,14,50,64,19,12,2,7,44,100
356,Jahlil Okafor\okafoja01,C,24,NOP,24,9,399,83,136,.610,1,2,.500,82,134,.612,.614,37,57,.649,43,68,111,35,5,19,35,61,204
357,Elie Okobo\okoboel01,PG,22,PHO,32,2,380,50,119,.420,18,46,.391,32,73,.438,.496,31,47,.660,8,33,41,67,15,3,13,29,149
358,Josh Okogie\okogijo01,SG,21,MIN,38,12,906,90,232,.388,26,99,.263,64,133,.481,.444,84,110,.764,48,120,168,58,41,19,57,86,290
359,KZ Okpala\okpalkz01,SF,20,MIA,3,0,3,0,0,,0,0,,0,0,,,0,0,,0,1,1,0,0,0,1,0,0
360,Kelly Olynyk\olynyke01,C,28,MIA,36,0,712,88,199,.442,49,119,.412,39,80,.488,.565,45,51,.882,28,134,162,45,24,10,41,91,270
361,Miye Oni\onimi01,SG,22,UTA,3,0,8,0,0,,0,0,,0,0,,,0,0,,0,1,1,0,0,0,1,0,0
362,Cedi Osman\osmande01,SF,24,CLE,41,41,1206,169,377,.448,77,195,.395,92,182,.505,.550,36,57,.632,18,124,142,86,34,12,59,94,451
363,Kelly Oubre\oubreke01,SF,24,PHO,40,40,1361,261,568,.460,73,209,.349,188,359,.524,.524,137,176,.778,48,205,253,64,59,30,61,132,732
364,Jabari Parker\parkeja01,PF,24,ATL,32,23,837,198,393,.504,31,115,.270,167,278,.601,.543,53,72,.736,54,137,191,58,42,15,60,93,480
365,Chandler Parsons\parsoch01,SF,31,ATL,5,0,54,5,18,.278,4,14,.286,1,4,.250,.389,0,0,,1,6,7,3,4,1,3,3,14
366,Eric Paschall\pascher01,PF,23,GSW,38,20,1019,197,400,.493,24,79,.304,173,321,.539,.523,102,129,.791,51,118,169,66,20,10,58,75,520
367,Anžejs Pasečņiks\pasecan01,C,24,WAS,15,0,306,46,89,.517,0,1,.000,46,88,.523,.517,25,41,.610,34,49,83,16,8,7,19,51,117
368,Patrick Patterson\pattepa01,PF,30,LAC,37,16,509,63,160,.394,45,121,.372,18,39,.462,.534,17,24,.708,25,78,103,27,6,3,11,31,188
369,Justin Patton\pattoju01,C,22,OKC,5,0,24,4,10,.400,1,4,.250,3,6,.500,.450,0,0,,1,4,5,2,0,0,2,4,9
370,Chris Paul\paulch01,PG,34,OKC,41,41,1306,235,500,.470,65,180,.361,170,320,.531,.535,141,157,.898,14,193,207,266,67,5,85,97,676
371,Elfrid Payton\paytoel01,PG,25,NYK,24,15,601,89,214,.416,10,41,.244,79,173,.457,.439,15,28,.536,26,69,95,137,35,7,44,46,203
372,Gary Payton\paytoga02,PG,27,WAS,12,10,265,32,68,.471,9,24,.375,23,44,.523,.537,4,7,.571,14,35,49,31,22,5,15,24,77
373,Norvel Pelle\pelleno01,SF,26,PHI,12,0,129,15,25,.600,0,0,,15,25,.600,.600,4,8,.500,11,32,43,5,1,17,10,28,34
374,Theo Pinson\pinsoth01,SG,24,BRK,24,0,318,42,142,.296,14,71,.197,28,71,.394,.345,15,16,.938,9,36,45,46,11,2,31,31,113
375,Mason Plumlee\plumlma01,C,29,DEN,41,1,722,118,199,.593,0,4,.000,118,195,.605,.593,62,110,.564,76,156,232,101,23,27,61,93,298
376,Vincent Poirier\poirivi01,C,26,BOS,11,0,51,7,18,.389,0,0,,7,18,.389,.389,3,4,.750,8,8,16,3,2,2,4,12,17
377,Jakob Pöltl\poeltja01,C,24,SAS,39,7,684,87,144,.604,0,0,,87,144,.604,.604,24,46,.522,73,149,222,71,19,56,33,65,198
378,Shamorie Ponds\pondssh01,PG,21,TOR,4,0,11,3,5,.600,1,2,.500,2,3,.667,.700,2,2,1.000,0,1,1,2,0,1,0,2,9
379,Jordan Poole\poolejo01,SG,20,GSW,36,9,762,83,299,.278,43,165,.261,40,134,.299,.349,54,67,.806,4,64,68,69,23,7,35,55,263
380,Kevin Porter\porteke02,SF,19,CLE,34,2,742,111,253,.439,27,91,.297,84,162,.519,.492,40,55,.727,12,100,112,66,29,6,59,89,289
381,Michael Porter\portemi01,PF,21,DEN,32,1,383,87,159,.547,22,54,.407,65,105,.619,.616,18,25,.720,28,75,103,19,9,14,24,50,214
382,Otto Porter\porteot01,SF,26,CHI,9,9,226,35,84,.417,16,40,.400,19,44,.432,.512,15,20,.750,8,23,31,14,9,3,7,20,101
383,Bobby Portis\portibo01,C,24,NYK,42,4,891,164,374,.439,46,125,.368,118,249,.474,.500,46,61,.754,64,179,243,62,22,9,42,78,420
384,Kristaps Porziņģis\porzikr01,PF,24,DAL,31,31,968,190,472,.403,68,198,.343,122,274,.445,.475,87,120,.725,54,237,291,45,18,66,52,94,535
385,Dwight Powell\poweldw01,C,28,DAL,38,35,1024,143,222,.644,10,38,.263,133,184,.723,.667,71,107,.664,72,146,218,56,34,22,35,100,367
386,Norman Powell\powelno01,SG,26,TOR,29,17,838,157,309,.508,58,142,.408,99,167,.593,.602,59,71,.831,15,95,110,50,31,11,45,55,431
387,Julius Randle\randlju01,PF,25,NYK,40,40,1283,281,622,.452,50,170,.294,231,452,.511,.492,149,211,.706,89,276,365,130,32,9,116,110,761
388,Josh Reaves\reavejo02,SG,22,DAL,2,0,1,0,1,.000,0,0,,0,1,.000,.000,0,0,,0,0,0,0,0,0,0,0,0
389,Cam Reddish\reddica01,SF,20,ATL,37,26,952,104,322,.323,38,142,.268,66,180,.367,.382,58,74,.784,23,112,135,59,38,17,62,73,304
390,J.J. Redick\redicjj01,SG,35,NOP,37,33,1053,182,403,.452,117,252,.464,65,151,.430,.597,100,111,.901,8,99,107,74,13,6,41,56,581
391,Naz Reid\reidna01,C,20,MIN,11,0,145,35,87,.402,15,48,.313,20,39,.513,.489,9,14,.643,9,21,30,10,4,6,8,28,94
392,Josh Richardson\richajo01,SG,26,PHI,34,34,1100,195,446,.437,59,174,.339,136,272,.500,.503,85,105,.810,28,85,113,117,34,22,71,95,534
393,Austin Rivers\riverau01,SG,27,HOU,38,3,870,106,264,.402,43,142,.303,63,122,.516,.483,37,53,.698,18,70,88,62,22,6,24,73,292
394,Duncan Robinson\robindu01,SF,25,MIA,40,35,1104,158,342,.462,127,295,.431,31,47,.660,.648,27,29,.931,7,123,130,41,22,11,26,112,470
395,Glenn Robinson\robingl02,SF,26,GSW,42,42,1336,205,442,.464,55,141,.390,150,301,.498,.526,51,60,.850,60,143,203,69,40,10,44,75,516
396,Jerome Robinson\robinje01,SG,22,LAC,34,0,392,42,119,.353,17,57,.298,25,62,.403,.424,10,17,.588,5,48,53,36,10,7,23,44,111
397,Justin Robinson\robinju01,PG,22,WAS,9,0,49,5,12,.417,3,5,.600,2,7,.286,.542,0,0,,1,4,5,7,0,1,3,2,13
398,Mitchell Robinson\robinmi01,C,21,NYK,38,7,857,159,223,.713,0,0,,159,223,.713,.713,59,97,.608,109,143,252,18,34,66,27,131,377
399,Rajon Rondo\rondora01,PG,33,LAL,27,2,582,80,197,.406,25,71,.352,55,126,.437,.470,20,25,.800,14,89,103,147,25,2,57,32,205
400,Derrick Rose\rosede01,PG,31,DET,36,2,929,265,534,.496,34,107,.318,231,427,.541,.528,87,99,.879,20,65,85,210,29,13,96,38,651
401,Terrence Ross\rosste01,SG,28,ORL,40,0,1023,182,447,.407,85,257,.331,97,190,.511,.502,84,99,.848,9,108,117,38,44,12,40,63,533
402,Terry Rozier\roziete01,PG,25,CHO,44,44,1504,284,670,.424,120,301,.399,164,369,.444,.513,115,136,.846,36,152,188,193,51,7,105,99,803
403,Ricky Rubio\rubiori01,PG,29,PHO,34,34,1098,166,402,.413,41,121,.339,125,281,.445,.464,89,107,.832,26,137,163,319,46,8,88,86,462
404,D'Angelo Russell\russeda01,SG,23,GSW,25,25,796,202,472,.428,85,231,.368,117,241,.485,.518,88,115,.765,8,79,87,154,21,8,78,53,577
405,Domantas Sabonis\sabondo01,C,23,IND,38,38,1305,276,521,.530,10,40,.250,266,481,.553,.539,126,173,.728,129,370,499,162,32,22,98,126,688
406,JaKarr Sampson\sampsja02,SF,26,IND,13,8,198,30,48,.625,2,10,.200,28,38,.737,.646,2,8,.250,8,26,34,4,6,7,6,25,64
407,Dario Šarić\saricda01,PF,25,PHO,41,38,1029,150,343,.437,54,168,.321,96,175,.549,.516,48,57,.842,61,194,255,77,27,11,53,95,402
408,Tomáš Satoranský\satorto01,PG,28,CHI,42,42,1208,155,345,.449,47,131,.359,108,214,.505,.517,75,86,.872,43,109,152,223,58,6,83,84,432
409,Admiral Schofield\schofad01,SF,22,WAS,24,2,288,30,74,.405,14,46,.304,16,28,.571,.500,9,12,.750,6,27,33,14,7,3,7,41,83
410,Dennis Schröder\schrode01,PG,26,OKC,40,0,1229,279,597,.467,75,209,.359,204,388,.526,.530,100,122,.820,13,137,150,146,27,10,114,90,733
411,Mike Scott\scottmi01,PF,31,PHI,42,7,780,89,221,.403,49,146,.336,40,75,.533,.514,18,21,.857,32,106,138,25,13,3,14,54,245
412,Thabo Sefolosha\sefolth01,PF,35,HOU,25,0,249,19,51,.373,11,32,.344,8,19,.421,.480,0,1,.000,13,41,54,16,10,4,7,24,49
413,Collin Sexton\sextoco01,SG,21,CLE,41,41,1290,298,657,.454,44,135,.326,254,522,.487,.487,130,156,.833,40,89,129,92,40,4,83,80,770
414,Landry Shamet\shamela01,SG,22,LAC,25,17,665,71,178,.399,50,135,.370,21,43,.488,.539,24,25,.960,3,50,53,41,10,5,21,76,216
415,Iman Shumpert\shumpim01,SG,29,BRK,13,0,241,21,64,.328,8,33,.242,13,31,.419,.391,4,7,.571,9,25,34,12,12,2,10,21,54
416,Pascal Siakam\siakapa01,PF,25,TOR,29,29,1050,268,586,.457,70,179,.391,198,407,.486,.517,107,132,.811,38,188,226,105,28,27,76,84,713
417,Chris Silva\silvach01,PF,23,MIA,30,0,249,38,55,.691,0,2,.000,38,53,.717,.691,28,41,.683,46,46,92,15,6,16,29,65,104
418,Ben Simmons\simmobe01,PG,23,PHI,40,40,1431,252,445,.566,2,5,.400,250,440,.568,.569,106,182,.582,76,228,304,337,85,27,139,137,612
419,Anfernee Simons\simonan01,SG,20,POR,42,1,936,148,357,.415,48,146,.329,100,211,.474,.482,45,59,.763,16,92,108,58,16,6,42,88,389
420,Alen Smailagić\smailal01,PF,19,GSW,9,0,92,16,29,.552,2,9,.222,14,20,.700,.586,8,10,.800,7,15,22,8,1,3,5,10,42
421,Marcus Smart\smartma01,SG,25,BOS,31,21,973,121,327,.370,64,189,.339,57,138,.413,.468,58,70,.829,25,75,100,143,48,14,40,75,364
422,Dennis Smith\smithde03,PG,22,NYK,21,1,339,41,126,.325,12,41,.293,29,85,.341,.373,15,30,.500,13,31,44,57,10,7,30,44,109
423,Ish Smith\smithis01,PG,31,WAS,40,12,1044,187,410,.456,38,108,.352,149,302,.493,.502,33,52,.635,19,100,119,181,33,15,53,61,445
424,Tony Snell\snellto01,SF,28,DET,38,36,1001,110,239,.460,69,165,.418,41,74,.554,.605,13,13,1.000,6,61,67,56,17,6,17,66,302
425,Omari Spellman\spellom01,PF,22,GSW,40,3,708,108,239,.452,35,84,.417,73,155,.471,.525,58,73,.795,71,120,191,40,28,21,46,47,309
426,Max Strus\strusma01,SG,23,CHI,2,0,6,2,3,.667,0,1,.000,2,2,1.000,.667,1,1,1.000,1,0,1,0,0,0,0,1,5
427,Edmond Sumner\sumneed01,PG,24,IND,15,2,227,30,69,.435,7,22,.318,23,47,.489,.486,8,11,.727,7,17,24,26,11,4,9,25,75
428,Caleb Swanigan\swanica01,PF,22,SAC,7,0,23,2,4,.500,0,0,,2,4,.500,.500,1,2,.500,2,5,7,2,1,2,6,8,5
429,Jayson Tatum\tatumja01,PF,21,BOS,39,39,1331,303,707,.429,91,254,.358,212,453,.468,.493,130,154,.844,39,229,268,111,52,33,85,80,827
430,Jeff Teague\teaguje01,PG,31,MIN,34,13,945,145,324,.448,33,87,.379,112,237,.473,.498,125,144,.868,15,73,88,208,25,13,76,70,448
431,Garrett Temple\templga01,SG,33,BRK,36,25,1052,131,356,.368,75,234,.321,56,122,.459,.473,41,54,.759,21,102,123,94,31,17,47,64,378
432,Daniel Theis\theisda01,C,27,BOS,36,35,787,112,215,.521,13,47,.277,99,168,.589,.551,36,52,.692,71,149,220,53,23,51,28,121,273
433,Isaiah Thomas\thomais02,PG,30,WAS,31,28,736,137,337,.407,57,142,.401,80,195,.410,.491,52,64,.813,7,39,46,125,12,5,64,64,383
434,Khyri Thomas\thomakh01,SG,23,DET,2,0,6,0,0,,0,0,,0,0,,,1,2,.500,0,0,0,0,0,0,0,0,1
435,Matt Thomas\thomama02,SG,25,TOR,15,0,180,27,58,.466,20,43,.465,7,15,.467,.638,5,7,.714,3,19,22,6,4,0,6,15,79
436,Tristan Thompson\thomptr01,C,28,CLE,39,39,1238,210,410,.512,3,8,.375,207,402,.515,.516,75,121,.620,163,246,409,84,28,38,76,93,498
437,Matisse Thybulle\thybuma01,SG,22,PHI,34,4,622,53,132,.402,33,79,.418,20,53,.377,.527,19,28,.679,15,33,48,41,48,28,30,76,158
438,Anthony Tolliver\tollian01,PF,34,POR,32,9,537,42,115,.365,29,87,.333,13,28,.464,.491,13,19,.684,27,81,108,28,8,9,21,50,126
439,Karl-Anthony Towns\townska01,C,24,MIN,23,23,779,207,403,.514,82,196,.418,125,207,.604,.615,113,142,.796,63,206,269,101,24,29,72,80,609
440,Gary Trent\trentga02,SG,21,POR,29,2,382,43,118,.364,28,74,.378,15,44,.341,.483,8,8,1.000,8,30,38,18,12,5,9,27,122
441,Allonzo Trier\trieral01,PG,24,NYK,19,1,233,37,82,.451,15,45,.333,22,37,.595,.543,31,39,.795,2,22,24,24,2,4,20,23,120
442,P.J. Tucker\tuckepj01,PF,34,HOU,40,40,1397,114,245,.465,60,161,.373,54,84,.643,.588,25,32,.781,62,227,289,57,45,17,46,130,313
443,Rayjon Tucker\tuckera01,SG,22,UTA,8,0,57,4,10,.400,0,5,.000,4,5,.800,.400,3,5,.600,1,7,8,2,1,0,1,4,11
444,Evan Turner\turneev01,PG,31,ATL,18,0,230,24,63,.381,0,5,.000,24,58,.414,.381,12,14,.857,7,29,36,36,8,8,25,18,60
445,Myles Turner\turnemy01,C,23,IND,33,33,975,149,329,.453,51,148,.345,98,181,.541,.530,72,96,.750,44,156,200,42,18,67,42,82,421
446,Jonas Valančiūnas\valanjo01,C,27,MEM,38,38,962,242,403,.600,25,58,.431,217,345,.629,.632,70,91,.769,102,271,373,76,12,37,77,97,579
447,Denzel Valentine\valende01,SF,26,CHI,23,0,271,52,122,.426,29,74,.392,23,48,.479,.545,5,5,1.000,3,39,42,22,14,5,12,28,138
448,Jarred Vanderbilt\vandeja01,SF,20,DEN,4,0,13,1,1,1.000,0,0,,1,1,1.000,1.000,0,0,,0,2,2,1,0,0,2,1,2
449,Fred VanVleet\vanvlfr01,PG,25,TOR,31,31,1125,183,464,.394,80,215,.372,103,249,.414,.481,111,131,.847,9,111,120,218,59,12,77,69,557
450,Noah Vonleh\vonleno01,C,24,MIN,28,1,347,47,86,.547,2,14,.143,45,72,.625,.558,23,28,.821,34,82,116,26,11,6,19,36,119
451,Nikola Vučević\vucevni01,C,29,ORL,31,31,976,229,508,.451,53,143,.371,176,365,.482,.503,75,94,.798,83,261,344,103,28,29,39,68,586
452,Dean Wade\wadede01,PF,23,CLE,7,0,47,7,10,.700,2,3,.667,5,7,.714,.800,0,1,.000,2,13,15,1,2,3,3,6,16
453,Moritz Wagner\wagnemo01,C,22,WAS,21,4,429,93,160,.581,22,56,.393,71,104,.683,.650,36,43,.837,34,93,127,28,15,13,43,81,244
454,Kemba Walker\walkeke02,PG,29,BOS,36,36,1148,269,608,.442,125,322,.388,144,286,.503,.545,134,155,.865,28,116,144,178,32,21,81,55,797
455,Lonnie Walker\walkelo01,SG,21,SAS,31,1,364,69,155,.445,15,42,.357,54,113,.478,.494,20,30,.667,12,53,65,17,11,4,21,36,173
456,Tyrone Wallace\wallaty01,SG,25,ATL,14,0,160,14,44,.318,1,15,.067,13,29,.448,.330,11,17,.647,3,19,22,13,7,1,10,19,40
457,Taurean Waller-Prince\princta02,SF,25,BRK,40,40,1214,179,470,.381,98,273,.359,81,197,.411,.485,34,44,.773,33,232,265,82,37,17,83,100,490
458,Derrick Walton\waltode01,PG,24,LAC,22,1,215,17,36,.472,9,21,.429,8,15,.533,.597,6,7,.857,2,13,15,21,4,0,4,19,49
459,Brad Wanamaker\wanambr01,PG,30,BOS,39,0,734,81,191,.424,18,52,.346,63,139,.453,.471,71,78,.910,13,68,81,109,25,10,45,72,251
460,T.J. Warren\warretj01,SF,26,IND,41,41,1326,291,575,.506,48,131,.366,243,444,.547,.548,101,125,.808,39,118,157,57,42,18,52,107,731
461,PJ Washington\washipj01,PF,21,CHO,39,39,1186,181,377,.480,55,132,.417,126,245,.514,.553,67,98,.684,32,182,214,79,37,35,62,110,484
462,Yuta Watanabe\watanyu01,SG,25,MEM,4,0,18,3,6,.500,1,2,.500,2,4,.500,.583,0,0,,1,4,5,0,0,1,1,1,7
463,Tremont Waters\watertr01,PG,22,BOS,5,0,39,8,20,.400,2,11,.182,6,9,.667,.450,4,4,1.000,0,3,3,5,3,2,5,4,22
464,Paul Watson\watsopa01,SG,25,ATL,2,0,17,0,7,.000,0,3,.000,0,4,.000,.000,0,0,,0,2,2,3,1,0,0,1,0
465,Russell Westbrook\westbru01,PG,31,HOU,34,34,1203,315,728,.433,39,165,.236,276,563,.490,.459,173,222,.779,51,214,265,244,51,12,147,127,842
466,Coby White\whiteco01,SG,19,CHI,42,0,1015,177,467,.379,76,221,.344,101,246,.411,.460,45,63,.714,17,131,148,93,32,3,64,60,475
467,Derrick White\whitede01,SG,25,SAS,37,11,870,125,268,.466,33,90,.367,92,178,.517,.528,71,87,.816,17,92,109,114,20,27,43,76,354
468,Hassan Whiteside\whiteha01,C,30,POR,38,38,1137,243,413,.588,2,4,.500,241,409,.589,.591,105,140,.750,155,377,532,46,15,109,74,112,593
469,Andrew Wiggins\wiggian01,SF,24,MIN,32,32,1109,272,623,.437,65,207,.314,207,416,.498,.489,119,159,.748,41,120,161,106,22,32,75,71,728
470,Grant Williams\willigr01,PF,21,BOS,38,1,573,44,117,.376,10,52,.192,34,65,.523,.419,28,40,.700,31,59,90,40,14,17,31,83,126
471,Johnathan Williams\willijo04,C,24,WAS,6,5,123,15,22,.682,0,1,.000,15,21,.714,.682,3,5,.600,13,25,38,6,1,5,2,7,33
472,Kenrich Williams\willike04,PF,25,NOP,35,18,779,49,143,.343,25,96,.260,24,47,.511,.430,9,24,.375,49,129,178,53,25,21,21,81,132
473,Lou Williams\willilo02,SG,33,LAC,39,5,1168,254,591,.430,74,195,.379,180,396,.455,.492,186,216,.861,17,99,116,242,24,6,121,55,768
474,Marvin Williams\willima02,PF,33,CHO,36,0,705,84,185,.454,40,106,.377,44,79,.557,.562,39,44,.886,13,82,95,34,25,16,22,62,247
475,Robert Williams\williro04,C,22,BOS,19,1,269,33,49,.673,0,0,,33,49,.673,.673,8,14,.571,23,64,87,21,17,21,16,34,74
476,Nigel Williams-Goss\willini01,PG,25,UTA,9,0,28,1,7,.143,0,2,.000,1,5,.200,.143,2,2,1.000,2,3,5,5,1,1,2,2,4
477,D.J. Wilson\wilsodj01,PF,23,MIL,24,0,228,32,77,.416,11,45,.244,21,32,.656,.487,5,7,.714,6,45,51,17,0,4,11,20,80
478,Justise Winslow\winslju01,SF,23,MIA,11,5,352,50,129,.388,6,27,.222,44,102,.431,.411,18,27,.667,16,57,73,44,7,5,24,38,124
479,Christian Wood\woodch01,PF,24,DET,38,1,639,128,225,.569,22,60,.367,106,165,.642,.618,83,116,.716,50,150,200,27,13,31,39,45,361
480,Delon Wright\wrighde01,SG,27,DAL,39,4,804,109,226,.482,25,65,.385,84,161,.522,.538,45,55,.818,37,105,142,123,51,17,31,48,288
481,Thaddeus Young\youngth01,PF,31,CHI,41,1,911,151,364,.415,45,134,.336,106,230,.461,.477,28,47,.596,62,126,188,72,46,11,60,75,375
482,Trae Young\youngtr01,PG,21,ATL,37,37,1303,346,782,.442,129,350,.369,217,432,.502,.525,257,304,.845,22,145,167,314,44,4,178,61,1078
483,Cody Zeller\zelleco01,C,27,CHO,41,22,945,183,343,.534,17,62,.274,166,281,.591,.558,89,128,.695,115,172,287,51,25,17,56,104,472
484,Ante Žižić\zizican01,C,23,CLE,16,0,159,28,49,.571,0,0,,28,49,.571,.571,13,15,.867,14,41,55,3,6,4,5,20,69
485,Ivica Zubac\zubaciv01,C,22,LAC,42,40,737,140,229,.611,0,2,.000,140,227,.617,.611,68,92,.739,105,185,290,38,7,42,37,97,348